//MAP CONVERTED BY dmm2tgm.py THIS HEADER COMMENT PREVENTS RECONVERSION, DO NOT REMOVE
"a" = (
/obj/structure/table/wood,
/obj/machinery/cell_charger,
/obj/item/storage/toolbox/mini/mechanical/loaded{
	pixel_x = 5;
	pixel_y = 8
	},
/obj/item/stock_parts/cell/high,
/turf/open/floor/iron/dark/textured,
/area/misc/survivalpod)
"c" = (
/obj/structure/table/optable,
/obj/item/storage/backpack/duffelbag/med/surgery,
/obj/machinery/light/nightshift/directional/north,
/turf/open/floor/iron/dark/textured,
/area/misc/survivalpod)
"e" = (
/obj/structure/sign/poster/contraband/c20r,
/turf/closed/wall/r_wall/syndicate/nodiagonal,
/area/misc/survivalpod)
"g" = (
/turf/open/floor/iron/dark/textured,
/area/misc/survivalpod)
"h" = (
/obj/structure/sign/poster/contraband/gorlex_recruitment,
/turf/closed/wall/r_wall/syndicate/nodiagonal,
/area/misc/survivalpod)
"j" = (
/obj/structure/table/wood,
/obj/machinery/recharger,
/obj/machinery/light/nightshift/directional/east,
/turf/open/floor/iron/dark/textured,
/area/misc/survivalpod)
"k" = (
/obj/structure/sign/poster/contraband/free_key,
/turf/closed/wall/r_wall/syndicate/nodiagonal,
/area/misc/survivalpod)
"o" = (
/obj/structure/rack,
/obj/item/clothing/under/starsuit,
/obj/item/clothing/head/helmet/space/starsuit,
/obj/item/tank/internals/emergency_oxygen,
/turf/open/floor/iron/dark/textured,
/area/misc/survivalpod)
"p" = (
/turf/template_noop,
/area/template_noop)
"q" = (
/obj/item/fulton_core,
/obj/structure/closet/cardboard,
/obj/item/extraction_pack,
/obj/item/storage/box/donkpockets,
/obj/item/gps/off,
/turf/open/floor/iron/dark/textured,
/area/misc/survivalpod)
"s" = (
/obj/structure/sign/poster/contraband/syndicate_recruitment,
/turf/closed/wall/r_wall/syndicate/nodiagonal,
/area/misc/survivalpod)
"t" = (
/obj/machinery/recharge_station,
/turf/open/floor/iron/dark/textured,
/area/misc/survivalpod)
"w" = (
/obj/structure/disposalpipe/segment{
	dir = 4
	},
/turf/closed/wall/r_wall/syndicate/nodiagonal,
/area/misc/survivalpod)
"z" = (
/turf/open/floor/carpet/black,
/area/misc/survivalpod)
"A" = (
/obj/machinery/disposal/delivery_chute{
	dir = 4
	},
/obj/structure/disposalpipe/trunk{
	dir = 8
	},
/obj/machinery/door/window/survival_pod{
	dir = 4
	},
/obj/structure/window/reinforced/survival_pod,
/turf/open/floor/engine,
/area/misc/survivalpod)
"C" = (
/turf/closed/wall/r_wall/syndicate/nodiagonal,
/area/misc/survivalpod)
"D" = (
/obj/machinery/disposal/delivery_chute{
	dir = 8
	},
/obj/structure/disposalpipe/trunk{
	dir = 4
	},
/obj/machinery/door/window/survival_pod{
	dir = 8
	},
/obj/structure/window/reinforced/survival_pod,
/turf/open/floor/engine,
/area/misc/survivalpod)
"E" = (
/obj/machinery/autolathe/hacked,
/obj/item/stack/sheet/iron/fifty,
/obj/item/stack/sheet/glass/fifty,
/turf/open/floor/iron/dark/textured,
/area/misc/survivalpod)
"G" = (
/obj/machinery/computer/operating,
/turf/open/floor/iron/dark/textured,
/area/misc/survivalpod)
"L" = (
/obj/machinery/stasis{
	dir = 4
	},
/turf/open/floor/iron/dark/textured,
/area/misc/survivalpod)
"N" = (
/obj/machinery/door/poddoor{
	can_open_with_hands = 1;
	autoclose = 1;
	req_access = list("syndicate")
	},
/obj/structure/fans/tiny,
/turf/open/floor/engine,
/area/misc/survivalpod)
"P" = (
/obj/machinery/reagentgrinder,
/obj/structure/table/wood,
/obj/machinery/light/nightshift/directional/west,
/turf/open/floor/iron/dark/textured,
/area/misc/survivalpod)
"Q" = (
/obj/structure/table/wood,
/obj/machinery/microwave,
/obj/item/storage/medkit/regular/wall{
	pixel_y = -28
	},
/turf/open/floor/iron/dark/textured,
/area/misc/survivalpod)
"V" = (
/obj/structure/sign/poster/contraband/revolver,
/turf/closed/wall/r_wall/syndicate/nodiagonal,
/area/misc/survivalpod)
"W" = (
/obj/structure/reagent_dispensers/water_cooler,
/turf/open/floor/iron/dark/textured,
/area/misc/survivalpod)
"X" = (
/obj/structure/sign/poster/contraband/syndicate_pistol,
/turf/closed/wall/r_wall/syndicate/nodiagonal,
/area/misc/survivalpod)
"Z" = (
/obj/machinery/computer/security/wooden_tv,
/turf/open/floor/carpet/black,
/area/misc/survivalpod)

(1,1,1) = {"
p
p
p
p
p
p
p
p
p
p
p
p
p
"}
(2,1,1) = {"
p
p
p
p
p
p
p
p
p
p
p
p
p
"}
(3,1,1) = {"
p
p
p
p
C
w
k
C
C
p
p
p
p
"}
(4,1,1) = {"
p
p
p
C
C
A
P
W
C
C
p
p
p
"}
(5,1,1) = {"
p
p
p
h
L
z
z
z
a
s
p
p
p
"}
(6,1,1) = {"
p
p
p
C
G
z
z
z
o
C
p
p
p
"}
(7,1,1) = {"
p
p
p
C
c
z
Z
z
g
N
p
p
p
"}
(8,1,1) = {"
p
p
p
C
t
z
z
z
g
C
p
p
p
"}
(9,1,1) = {"
p
p
p
e
E
z
z
z
q
X
p
p
p
"}
(10,1,1) = {"
p
p
p
C
C
D
j
Q
C
C
p
p
p
"}
(11,1,1) = {"
p
p
p
p
C
w
V
C
C
p
p
p
p
"}
(12,1,1) = {"
p
p
p
p
p
p
p
p
p
p
p
p
p
"}
(13,1,1) = {"
p
p
p
p
p
p
p
p
p
p
p
p
p
"}
